5012,5002,5002,5002,5002,5002,5002,5002,5002,5002,5002,5002,5002,
901,901,901,901,901,931,901,901,901,901,901,901,901,
1201,1201,1201,1221,1201,1201,1201,1201,1201,1201,1201,1201,1201,
1001,1001,1001,1001,1001,1001,1001,1001,1001,1071,1001,1001,1041,
1101,1151,1101,1101,1101,1101,1101,1101,1101,1101,1101,1101,1101,
821,821,821,821,821,821,801,801,801,801,801,801,801